NO ./images/NO.xpm
WE ./images/WE.xpm
SO ./images/SO.xpm
EA ./images/EA.xpm
C 255,255 ,255
F 00,153,15


        1111111111111111111111111
        1000000000000000000000001
111111111000000000000000000000001
100000000000000000000000000001111
10000000000000S10000000000001
10000000000000000000000000001
10000000000000000000000000001
10000000000000000000000000001
10000000000000000001010000001
11000001110101011111011110101
11110111 1110111 101111010001
11111111 1111111 111111111111
