NO ./images/NO.xpm
SO ./images/SO.xpm
WE ./images/WE.xpm
EA ./images/EA.xpm
F 00,153,15
C 155,155,155
        N111111111111111111111111
        1000000000000000000000011
        1100000000000001111111111
        1000100000000001
111111110000000000000001
10000000000000000000000011111
11111111111111110000000000001
10000000000000010000000000001
10000111111111110000000000001
10100000000000000000000000001
10000000000000011111100000001
1001111111000001    100000011
10000011 1000001    100000001
11111111 1111111    111111111
